8
-.-.-.-.-.-.-.-
-.P.-.-.G.-.P.-
W.-.-.-.-.-.-.-
-.-.-.W.-.-.P.-
-.P.-.-.-.-.-.-
-.-.P.-.-.P.-.-
-.G.-.-.-.W.-.-
-.-.-.P.-.-.-.-